Русский	ru
English	en
عربي	ar
Български	bg
Čeština	cs
中文	zh
Dansk	da
Suomi	fi
Français	fr
Deutsch	de
Ελληνικά	el
עברית	he
हिन्दी"	hi
Español	es
Magyar	hu
Gaeilge	ga
Italiano	it
日本語	ja
Català	ca
한국어	ko
Hrvatski	hr
Lietuvių	lt
Nederlands	nl
Norsk	no
فارسی	fa
Polski	pl
Português	pt
Română	ro
Српски	sr
Slovenčina	sk
Slovensko	sl
Hornjoserbsce	hsb
Kiswahili	sw
Svenska	sv
ไทย	th
Türkçe	tr
Українська	uk
Việt nam	vi